1111111111
1E00000001
10000000C1
1P000000X1
1111111111